111111111111111111
100000100000000001
1000C0100000000001
100000111000000001
100000000000000001
100000001110000P01
1E0110000100000001
111100C00000000001
100000000000000001
111111111111111111
