111111111111111111111
100000000000000000001
1000C0000000000P00001
100000000111100000001
111000000011000000001
1E0000000001C00000001
100000000000000000001
100000000000000000001
100000000000000000001
100000000000000000001
100000000000000000001
100000000000000000001
111111111111111111111
