11111111111111111
1E000000000C00001
11110001100100101
10000000000001001
100C0100000100001
111111100C0100001
100000000000000P1
11111111111111111
